//MAP CONVERTED BY dmm2tgm.py THIS HEADER COMMENT PREVENTS RECONVERSION, DO NOT REMOVE
"a" = (
/turf/space,
/area/submap/jobship/medsci/meridian_dawn/class_a)
"b" = (
/obj/effect/floor_decal/industrial/warning{
	dir = 5
	},
/obj/machinery/light/small{
	dir = 4
	},
/obj/machinery/atmospherics/unary/vent_pump/high_volume{
	dir = 4
	},
/obj/effect/map_helper/airlock/atmos/chamber_pump,
/turf/simulated/floor/tiled,
/area/space)
"c" = (
/turf/space,
/area/space)
"d" = (
/obj/machinery/atmospherics/pipe/simple/hidden{
	dir = 9
	},
/obj/effect/wingrille_spawn/reinforced,
/turf/space,
/turf/simulated/floor,
/area/space)
"h" = (
/obj/structure/closet/emcloset,
/obj/machinery/light{
	dir = 4
	},
/obj/effect/floor_decal/borderfloor,
/obj/effect/floor_decal/corner/green/border,
/turf/simulated/floor/tiled,
/area/space)
"j" = (
/obj/effect/floor_decal/industrial/warning{
	dir = 9
	},
/obj/machinery/light/small{
	dir = 8
	},
/obj/machinery/atmospherics/unary/vent_pump/high_volume{
	dir = 8;
	frequency = 1380;
	id_tag = null
	},
/obj/effect/map_helper/airlock/atmos/chamber_pump,
/obj/structure/cable{
	d1 = 1;
	d2 = 2;
	icon_state = "1-2"
	},
/turf/simulated/floor/tiled,
/area/space)
"k" = (
/obj/machinery/atmospherics/pipe/simple/hidden{
	dir = 5
	},
/obj/effect/wingrille_spawn/reinforced,
/turf/simulated/floor,
/area/space)
"m" = (
/obj/machinery/door/firedoor/glass,
/obj/effect/wingrille_spawn/reinforced,
/turf/simulated/floor,
/area/space)
"n" = (
/obj/effect/wingrille_spawn/reinforced,
/turf/simulated/floor,
/area/space)
"o" = (
/obj/effect/floor_decal/industrial/warning{
	dir = 10
	},
/obj/machinery/airlock_sensor{
	dir = 4;
	frequency = 1380;
	id_tag = null;
	pixel_x = -27
	},
/obj/machinery/atmospherics/unary/vent_pump/high_volume{
	dir = 8;
	frequency = 1380;
	id_tag = null
	},
/obj/effect/map_helper/airlock/atmos/chamber_pump,
/obj/effect/map_helper/airlock/sensor/chamber_sensor,
/obj/structure/cable{
	d1 = 1;
	d2 = 2;
	icon_state = "1-2"
	},
/turf/simulated/floor/tiled,
/area/space)
"p" = (
/obj/effect/floor_decal/industrial/hatch/yellow,
/obj/machinery/door/airlock/glass_external{
	icon_state = "door_locked";
	locked = 1;
	name = "Dock Internal Airlock"
	},
/obj/effect/map_helper/airlock/door/int_door,
/obj/structure/cable{
	d1 = 1;
	d2 = 2;
	icon_state = "1-2"
	},
/turf/simulated/floor/tiled/dark,
/area/space)
"v" = (
/obj/machinery/shield_diffuser,
/obj/effect/floor_decal/industrial/hatch/yellow,
/obj/machinery/door/airlock/external{
	icon_state = "door_locked";
	locked = 1;
	name = "Dock External Airlock";
	req_one_access = list(13)
	},
/obj/machinery/access_button{
	master_tag = null;
	name = "exterior access button";
	pixel_x = -27;
	pixel_y = -7
	},
/obj/effect/map_helper/airlock/button/ext_button,
/obj/effect/map_helper/airlock/door/ext_door,
/obj/structure/cable{
	d1 = 1;
	d2 = 2;
	icon_state = "1-2"
	},
/turf/simulated/floor/tiled/dark,
/area/space)
"x" = (
/obj/machinery/shield_diffuser,
/obj/effect/floor_decal/industrial/hatch/yellow,
/obj/machinery/door/airlock/external{
	icon_state = "door_locked";
	locked = 1;
	name = "Dock External Airlock";
	req_one_access = list(13)
	},
/obj/effect/map_helper/airlock/door/ext_door,
/obj/structure/cable{
	d1 = 1;
	d2 = 2;
	icon_state = "1-2"
	},
/turf/simulated/floor/tiled/dark,
/area/space)
"y" = (
/obj/effect/floor_decal/industrial/warning{
	dir = 5
	},
/obj/machinery/atmospherics/unary/vent_pump/high_volume{
	dir = 4;
	frequency = 1380;
	id_tag = null
	},
/obj/effect/map_helper/airlock/atmos/chamber_pump,
/obj/machinery/embedded_controller/radio/airlock/docking_port{
	dir = 8;
	frequency = 1380;
	id_tag = "d1_aux_b_airlock";
	pixel_x = 27;
	req_access = null;
	req_one_access = list(13);
	tag_airpump = null;
	tag_chamber_sensor = null;
	tag_exterior_door = null;
	tag_interior_door = null
	},
/turf/simulated/floor/tiled,
/area/space)
"z" = (
/obj/effect/floor_decal/industrial/hatch/yellow,
/obj/machinery/door/airlock/glass_external{
	icon_state = "door_locked";
	locked = 1;
	name = "Dock Internal Airlock"
	},
/obj/machinery/access_button{
	command = "cycle_interior";
	dir = 1;
	master_tag = null;
	name = "interior access button";
	pixel_x = -27;
	pixel_y = 7
	},
/obj/effect/map_helper/airlock/button/int_button,
/obj/effect/map_helper/airlock/door/int_door,
/obj/structure/cable{
	d1 = 1;
	d2 = 2;
	icon_state = "1-2"
	},
/turf/simulated/floor/tiled/dark,
/area/space)
"A" = (
/obj/effect/floor_decal/industrial/warning{
	dir = 10
	},
/obj/machinery/atmospherics/unary/vent_pump/high_volume{
	dir = 8
	},
/obj/effect/map_helper/airlock/atmos/chamber_pump,
/obj/structure/cable{
	d1 = 1;
	d2 = 2;
	icon_state = "1-2"
	},
/turf/simulated/floor/tiled,
/area/space)
"B" = (
/obj/effect/shuttle_landmark{
	base_area = /area/space;
	base_turf = /turf/space;
	landmark_tag = "d1_aux_c";
	name = "Deck 1 Aux Dock C"
	},
/turf/space,
/area/submap/jobship/medsci/meridian_dawn/class_a)
"C" = (
/obj/machinery/atmospherics/pipe/simple/hidden{
	dir = 9
	},
/obj/effect/wingrille_spawn/reinforced,
/turf/simulated/floor,
/area/space)
"D" = (
/obj/structure/sign/warning/docking_area,
/turf/simulated/wall/r_wall,
/area/space)
"E" = (
/turf/simulated/floor/tiled/monotile,
/area/space)
"F" = (
/obj/machinery/shield_diffuser,
/obj/effect/floor_decal/industrial/hatch/yellow,
/obj/machinery/door/airlock/external{
	icon_state = "door_locked";
	locked = 1;
	name = "Dock External Airlock";
	req_one_access = list(13)
	},
/obj/machinery/access_button{
	frequency = 1380;
	name = "exterior access button";
	pixel_x = 27;
	pixel_y = -7
	},
/obj/effect/map_helper/airlock/door/ext_door,
/obj/effect/map_helper/airlock/button/ext_button,
/turf/simulated/floor/tiled/dark,
/area/space)
"G" = (
/obj/effect/floor_decal/borderfloor/corner,
/obj/effect/floor_decal/corner/green/bordercorner,
/turf/simulated/floor/tiled,
/area/space)
"H" = (
/obj/machinery/atmospherics/pipe/simple/hidden,
/turf/simulated/wall/r_wall,
/area/space)
"I" = (
/obj/structure/closet/emcloset,
/obj/machinery/light{
	dir = 8
	},
/obj/effect/floor_decal/borderfloor,
/obj/effect/floor_decal/corner/green/border,
/turf/simulated/floor/tiled,
/area/space)
"J" = (
/obj/effect/floor_decal/industrial/warning{
	dir = 6
	},
/obj/machinery/airlock_sensor{
	dir = 8;
	id_tag = null;
	pixel_x = 27
	},
/obj/machinery/atmospherics/unary/vent_pump/high_volume{
	dir = 4
	},
/obj/effect/map_helper/airlock/atmos/chamber_pump,
/obj/effect/map_helper/airlock/sensor/chamber_sensor,
/turf/simulated/floor/tiled,
/area/space)
"K" = (
/obj/effect/shuttle_landmark{
	base_area = /area/space;
	base_turf = /turf/space;
	docking_controller = "d1_aux_b_airlock";
	landmark_tag = "d1_aux_b";
	name = "Deck 1 Aux Dock B"
	},
/turf/space,
/area/submap/jobship/medsci/meridian_dawn/class_a)
"L" = (
/obj/machinery/shield_diffuser,
/obj/effect/floor_decal/industrial/hatch/yellow,
/obj/machinery/door/airlock/external{
	icon_state = "door_locked";
	locked = 1;
	name = "Dock External Airlock";
	req_one_access = list(13)
	},
/obj/effect/map_helper/airlock/door/ext_door,
/turf/simulated/floor/tiled/dark,
/area/space)
"N" = (
/obj/machinery/atmospherics/pipe/manifold/hidden{
	dir = 8
	},
/obj/effect/wingrille_spawn/reinforced,
/turf/simulated/floor,
/area/space)
"O" = (
/obj/effect/floor_decal/industrial/hatch/yellow,
/obj/machinery/door/airlock/glass_external{
	icon_state = "door_locked";
	locked = 1;
	name = "Dock Internal Airlock"
	},
/obj/effect/map_helper/airlock/door/int_door,
/obj/machinery/access_button{
	dir = 1;
	frequency = 1380;
	master_tag = null;
	name = "interior access button";
	pixel_x = 27;
	pixel_y = 7
	},
/obj/effect/map_helper/airlock/button/int_button,
/turf/simulated/floor/tiled/dark,
/area/space)
"P" = (
/obj/machinery/atmospherics/pipe/manifold/hidden{
	dir = 4
	},
/obj/effect/wingrille_spawn/reinforced,
/turf/simulated/floor,
/area/space)
"Q" = (
/obj/structure/table/bench/standard,
/obj/effect/floor_decal/borderfloor{
	dir = 6
	},
/obj/effect/floor_decal/corner/green/border{
	dir = 6
	},
/turf/simulated/floor/tiled,
/area/space)
"R" = (
/obj/effect/floor_decal/industrial/hatch/yellow,
/obj/machinery/door/airlock/glass_external{
	icon_state = "door_locked";
	locked = 1;
	name = "Dock Internal Airlock"
	},
/obj/effect/map_helper/airlock/door/int_door,
/turf/simulated/floor/tiled/dark,
/area/space)
"S" = (
/obj/effect/floor_decal/borderfloor/corner{
	dir = 8
	},
/obj/effect/floor_decal/corner/green/bordercorner{
	dir = 8
	},
/turf/simulated/floor/tiled,
/area/space)
"T" = (
/obj/structure/table/bench/standard,
/obj/effect/floor_decal/borderfloor,
/obj/effect/floor_decal/corner/green/border,
/turf/simulated/floor/tiled,
/area/space)
"U" = (
/obj/structure/lattice,
/obj/machinery/shield_diffuser,
/turf/space,
/area/submap/jobship/medsci/meridian_dawn/class_a)
"V" = (
/obj/effect/floor_decal/industrial/warning{
	dir = 6
	},
/obj/machinery/atmospherics/unary/vent_pump/high_volume{
	dir = 4;
	frequency = 1380;
	id_tag = null
	},
/obj/effect/map_helper/airlock/atmos/chamber_pump,
/turf/simulated/floor/tiled,
/area/space)
"W" = (
/obj/structure/table/bench/standard,
/obj/effect/floor_decal/borderfloor{
	dir = 10
	},
/obj/effect/floor_decal/corner/green/border{
	dir = 10
	},
/turf/simulated/floor/tiled,
/area/space)
"X" = (
/obj/machinery/door/firedoor/border_only,
/obj/effect/wingrille_spawn/reinforced,
/turf/simulated/floor,
/area/space)
"Y" = (
/turf/simulated/wall/r_wall,
/area/space)
"Z" = (
/obj/effect/floor_decal/industrial/warning{
	dir = 9
	},
/obj/machinery/atmospherics/unary/vent_pump/high_volume{
	dir = 8
	},
/obj/effect/map_helper/airlock/atmos/chamber_pump,
/obj/machinery/embedded_controller/radio/airlock/docking_port{
	dir = 4;
	frequency = 1380;
	id_tag = "d1_aux_c_airlock";
	pixel_x = -27;
	req_one_access = list(13)
	},
/obj/structure/cable{
	d1 = 1;
	d2 = 2;
	icon_state = "1-2"
	},
/turf/simulated/floor/tiled,
/area/space)

(1,1,1) = {"
c
c
c
c
c
c
c
c
c
c
c
c
c
c
c
c
c
c
c
c
c
c
c
c
c
c
c
c
c
c
c
c
c
c
c
c
"}
(2,1,1) = {"
c
c
c
c
c
c
c
c
c
c
c
c
c
c
c
c
c
c
c
c
c
c
c
c
c
c
c
c
c
c
c
c
c
c
c
c
"}
(3,1,1) = {"
c
c
c
c
c
c
c
c
c
c
c
c
c
c
c
c
c
c
c
c
c
c
c
c
c
c
c
c
c
c
c
c
c
c
c
c
"}
(4,1,1) = {"
c
c
c
c
c
c
c
c
c
c
c
c
c
c
c
c
c
c
c
c
c
c
c
c
c
c
c
c
c
c
c
c
c
c
c
c
"}
(5,1,1) = {"
c
c
c
c
c
c
c
c
c
a
a
a
a
a
a
a
a
a
a
a
a
a
a
a
a
a
a
c
c
c
c
c
c
c
c
c
"}
(6,1,1) = {"
c
c
c
c
c
c
c
c
c
a
a
a
a
a
a
a
a
a
a
a
a
a
a
a
a
a
a
c
c
c
c
c
c
c
c
c
"}
(7,1,1) = {"
c
c
c
c
c
c
c
c
c
a
a
a
a
a
a
a
a
a
a
a
a
a
a
a
a
a
a
c
c
c
c
c
c
c
c
c
"}
(8,1,1) = {"
c
c
c
c
c
c
c
a
a
a
a
a
a
a
a
a
a
a
a
a
a
a
a
a
a
a
a
a
a
c
c
c
c
c
c
c
"}
(9,1,1) = {"
c
c
c
c
c
c
c
a
a
a
a
a
a
a
a
a
a
a
a
a
a
a
a
a
a
a
a
a
a
c
c
c
c
c
c
c
"}
(10,1,1) = {"
c
c
c
c
c
c
c
a
a
a
a
a
a
a
a
a
a
a
a
a
a
a
a
a
a
a
a
a
a
c
c
c
c
c
c
c
"}
(11,1,1) = {"
c
c
c
c
c
c
c
a
a
a
a
a
a
a
a
a
a
a
a
a
a
a
a
a
a
a
a
a
a
c
c
c
c
c
c
c
"}
(12,1,1) = {"
c
c
c
c
c
c
c
a
a
a
a
a
a
a
a
a
a
a
a
a
a
a
a
a
a
a
a
a
a
c
c
c
c
c
c
c
"}
(13,1,1) = {"
c
c
c
c
c
c
c
a
a
a
a
a
a
a
a
a
a
a
a
a
a
a
a
a
a
a
a
a
a
c
c
c
c
c
c
c
"}
(14,1,1) = {"
c
c
c
c
c
c
c
a
a
a
a
a
a
a
a
a
a
a
a
a
a
a
a
a
a
a
a
a
a
c
c
c
c
c
c
c
"}
(15,1,1) = {"
c
c
c
c
c
c
c
a
a
a
a
a
a
a
a
a
a
a
a
a
a
a
a
a
a
a
a
a
a
c
c
c
c
c
c
c
"}
(16,1,1) = {"
c
c
c
c
c
c
c
a
a
a
a
a
a
a
a
a
a
a
a
a
a
a
a
a
a
a
a
a
a
c
c
c
c
c
c
c
"}
(17,1,1) = {"
c
c
c
c
c
c
c
a
a
a
a
a
a
a
a
a
a
a
a
a
a
a
a
a
a
a
a
a
a
c
c
c
c
c
c
c
"}
(18,1,1) = {"
c
c
c
c
c
c
c
a
a
a
a
a
a
a
a
a
a
a
a
a
a
a
a
a
a
a
a
a
a
c
c
c
c
c
c
c
"}
(19,1,1) = {"
c
c
c
c
c
c
c
a
a
a
a
a
a
a
a
a
a
a
a
a
a
a
a
a
a
a
a
a
a
c
c
c
c
c
c
c
"}
(20,1,1) = {"
c
c
c
c
c
c
c
a
a
a
a
a
a
a
a
a
a
a
a
a
a
a
a
a
a
a
a
a
a
c
c
c
c
c
c
c
"}
(21,1,1) = {"
c
c
c
c
c
c
c
a
a
a
a
a
a
a
a
a
a
a
a
a
a
a
a
a
a
a
a
a
a
c
c
c
c
c
c
c
"}
(22,1,1) = {"
c
c
c
c
c
c
c
a
a
a
a
a
a
a
a
a
a
a
a
a
a
a
a
a
a
a
a
a
a
c
c
c
c
c
c
c
"}
(23,1,1) = {"
c
c
c
c
c
c
c
a
a
a
a
a
a
a
a
a
a
a
a
a
a
a
a
a
a
a
a
a
a
c
c
c
c
c
c
c
"}
(24,1,1) = {"
c
c
c
c
c
c
c
a
a
a
a
a
a
a
a
a
a
a
a
a
a
a
a
a
a
a
a
a
a
c
c
c
c
c
c
c
"}
(25,1,1) = {"
c
c
c
c
c
c
c
a
a
a
a
a
a
a
a
a
a
a
a
a
a
a
a
a
a
a
a
a
a
c
c
c
c
c
c
c
"}
(26,1,1) = {"
c
c
c
c
c
c
c
a
a
a
a
a
a
a
a
a
a
a
a
a
a
a
a
a
a
a
a
a
a
c
c
c
c
c
c
c
"}
(27,1,1) = {"
c
c
c
c
c
c
c
a
a
a
a
a
a
a
a
a
a
a
a
a
a
a
a
a
a
a
a
a
a
c
c
c
c
c
c
c
"}
(28,1,1) = {"
c
c
c
c
c
c
c
a
a
a
a
a
a
a
a
a
a
a
a
a
a
a
a
a
a
a
a
a
a
c
c
c
c
c
c
c
"}
(29,1,1) = {"
c
c
c
c
c
c
c
a
a
a
a
a
a
a
a
a
a
a
a
a
a
a
a
a
a
a
a
a
a
c
c
c
c
c
c
c
"}
(30,1,1) = {"
c
c
c
c
c
c
c
a
a
a
a
a
a
a
a
a
a
a
a
a
a
a
a
a
a
a
a
a
a
c
c
c
c
c
c
c
"}
(31,1,1) = {"
c
c
c
c
c
c
c
a
a
a
a
a
a
a
a
a
a
a
a
a
a
a
a
a
a
a
a
a
a
c
c
c
c
c
c
c
"}
(32,1,1) = {"
c
c
c
c
c
c
c
a
a
a
a
a
a
a
a
a
a
a
a
a
a
a
a
a
a
a
a
a
a
c
c
c
c
c
c
c
"}
(33,1,1) = {"
c
c
c
c
c
c
c
a
a
a
a
a
a
a
a
a
a
a
a
a
a
a
a
a
a
a
a
a
a
c
c
c
c
c
c
c
"}
(34,1,1) = {"
c
c
c
c
c
c
c
a
a
a
a
a
a
a
a
a
a
a
a
a
a
a
a
a
a
a
a
a
a
c
c
c
c
c
c
c
"}
(35,1,1) = {"
c
c
c
c
c
c
c
a
a
a
a
a
a
a
a
a
a
a
a
a
a
a
a
a
a
a
a
a
a
c
c
c
c
c
c
c
"}
(36,1,1) = {"
c
c
c
c
c
c
c
a
a
a
a
a
a
a
a
a
a
a
a
a
a
a
a
a
a
a
a
a
a
c
c
c
c
c
c
c
"}
(37,1,1) = {"
c
c
c
c
c
c
c
a
a
a
a
a
a
a
a
a
a
a
a
a
a
a
a
a
a
a
a
a
a
c
c
c
c
c
c
c
"}
(38,1,1) = {"
c
c
c
c
c
c
c
a
a
a
a
a
a
a
a
a
a
a
a
a
a
a
a
a
a
a
a
a
a
c
c
c
c
c
c
c
"}
(39,1,1) = {"
c
c
c
c
c
c
c
a
a
a
a
a
a
a
a
a
a
a
a
a
a
a
a
a
a
a
a
a
a
c
c
c
c
c
c
c
"}
(40,1,1) = {"
c
c
c
c
c
c
c
a
a
a
a
a
a
a
a
a
a
a
a
a
a
a
a
a
a
a
a
a
a
c
c
c
c
c
c
c
"}
(41,1,1) = {"
c
c
c
c
c
c
c
a
a
a
a
a
a
a
a
a
a
a
a
a
a
a
a
a
a
a
a
a
a
c
c
c
c
c
c
c
"}
(42,1,1) = {"
c
c
c
c
c
c
c
a
a
a
a
a
a
a
a
a
a
a
a
a
a
a
a
a
a
a
a
a
a
c
c
c
c
c
c
c
"}
(43,1,1) = {"
c
c
c
c
c
c
c
a
a
a
a
a
a
a
a
a
a
a
a
a
a
a
a
a
a
a
a
a
a
c
c
c
c
c
c
c
"}
(44,1,1) = {"
c
c
c
c
c
c
c
a
a
a
a
a
a
a
a
a
a
a
a
a
a
a
a
a
a
a
a
a
a
c
c
c
c
c
c
c
"}
(45,1,1) = {"
c
c
c
c
c
c
c
a
a
a
a
a
a
a
a
a
a
a
a
a
a
a
a
a
a
a
a
a
a
c
c
c
c
c
c
c
"}
(46,1,1) = {"
c
c
c
c
c
c
c
a
a
a
a
a
a
a
a
a
a
a
a
a
a
a
a
a
a
a
a
a
a
c
c
c
a
c
c
c
"}
(47,1,1) = {"
c
c
c
c
c
c
c
a
a
a
a
a
a
a
a
a
a
a
a
a
a
a
a
a
a
a
a
a
a
c
c
c
a
c
c
c
"}
(48,1,1) = {"
c
c
c
c
c
c
c
a
a
a
a
a
a
a
a
a
a
a
a
a
a
a
a
a
a
a
a
a
a
c
c
c
a
c
c
c
"}
(49,1,1) = {"
c
c
c
c
c
c
c
a
a
a
a
a
a
a
a
a
a
a
a
a
a
a
a
a
a
a
a
a
a
c
c
a
a
a
c
c
"}
(50,1,1) = {"
c
c
c
c
c
c
c
a
a
a
a
a
a
a
a
a
a
a
a
a
a
a
a
a
a
a
a
a
a
c
c
a
a
a
c
c
"}
(51,1,1) = {"
c
c
c
c
c
c
c
a
a
a
a
a
a
a
a
a
a
a
a
a
a
a
a
a
a
a
a
a
a
c
c
a
a
a
c
c
"}
(52,1,1) = {"
c
c
c
c
c
c
c
a
a
a
a
a
a
a
a
a
a
a
a
a
a
a
a
a
a
a
a
a
a
c
c
a
a
a
c
c
"}
(53,1,1) = {"
c
c
c
c
c
c
c
a
a
a
a
a
a
a
a
a
a
a
a
a
a
a
a
a
a
a
a
a
a
c
c
a
a
a
c
c
"}
(54,1,1) = {"
c
c
c
c
c
c
c
a
a
a
a
a
a
a
a
a
a
a
a
a
a
a
a
a
a
a
a
a
a
c
c
a
a
a
c
c
"}
(55,1,1) = {"
c
c
c
c
c
c
c
a
a
a
a
a
a
a
a
a
a
a
a
a
a
a
a
a
a
a
a
a
a
c
c
a
a
a
c
c
"}
(56,1,1) = {"
c
c
c
c
c
c
c
a
a
a
a
a
a
a
a
a
a
a
a
a
a
a
a
a
a
a
a
a
a
c
c
a
a
a
c
c
"}
(57,1,1) = {"
c
c
c
c
c
c
c
a
a
a
a
a
a
a
a
a
a
a
a
a
a
a
a
a
a
a
a
a
a
a
a
a
a
a
c
c
"}
(58,1,1) = {"
c
c
c
c
c
c
c
a
a
a
a
a
a
a
a
a
a
a
a
a
a
a
a
a
a
a
a
a
a
a
a
a
a
a
c
c
"}
(59,1,1) = {"
c
c
c
c
c
c
c
a
a
a
a
a
a
a
a
a
a
a
a
a
a
a
a
a
a
a
a
a
a
a
a
a
a
c
c
c
"}
(60,1,1) = {"
c
c
c
c
c
c
c
a
a
a
a
a
a
a
a
a
a
a
a
a
a
a
a
a
a
a
a
a
a
a
a
a
c
c
c
c
"}
(61,1,1) = {"
c
c
c
c
c
c
c
a
a
a
a
a
a
a
a
a
a
a
a
a
a
a
a
a
a
a
a
a
a
a
a
c
c
c
c
c
"}
(62,1,1) = {"
c
c
c
c
c
c
c
a
a
a
a
a
a
a
a
a
a
a
a
a
a
a
a
a
a
a
a
a
a
a
c
c
c
c
c
c
"}
(63,1,1) = {"
c
c
c
c
c
c
c
a
a
a
a
a
a
a
a
a
a
a
a
a
a
a
a
a
a
a
a
a
a
c
c
c
c
c
c
c
"}
(64,1,1) = {"
c
c
c
c
c
c
c
a
a
a
a
a
a
a
a
a
a
a
a
a
a
a
a
a
a
a
a
a
a
c
c
c
c
c
c
c
"}
(65,1,1) = {"
c
c
c
c
c
c
c
a
a
a
a
a
a
a
a
a
a
a
a
a
a
a
a
a
a
a
a
a
a
c
c
c
c
c
c
c
"}
(66,1,1) = {"
c
c
c
c
c
c
c
a
a
a
a
a
a
a
a
a
a
a
a
a
a
a
a
a
a
a
a
a
a
c
c
c
c
c
c
c
"}
(67,1,1) = {"
c
c
c
c
c
c
c
a
a
a
a
a
a
a
a
a
a
a
a
a
a
a
a
a
a
a
a
a
a
c
c
c
c
c
c
c
"}
(68,1,1) = {"
c
c
c
c
c
c
c
a
a
a
a
a
a
a
a
a
a
a
a
a
a
a
a
a
a
a
a
a
a
c
c
c
c
c
c
c
"}
(69,1,1) = {"
c
c
c
c
c
c
c
a
a
a
a
a
a
a
a
a
a
a
a
a
a
a
a
a
a
a
a
a
a
c
c
c
c
c
c
c
"}
(70,1,1) = {"
c
c
c
c
c
c
c
a
a
a
a
a
a
a
a
a
a
a
a
a
a
a
a
a
a
a
a
a
a
c
c
c
c
c
c
c
"}
(71,1,1) = {"
c
c
c
c
c
c
c
a
a
a
a
a
a
a
a
a
a
a
a
a
a
a
a
a
a
a
a
a
a
c
c
c
c
c
c
c
"}
(72,1,1) = {"
c
c
c
c
c
c
c
a
a
a
a
a
a
a
a
a
a
a
a
a
a
a
a
a
a
a
a
a
a
c
c
c
c
c
c
c
"}
(73,1,1) = {"
c
c
c
c
c
c
c
a
a
a
a
a
a
a
a
a
a
a
a
a
a
a
a
a
a
a
a
a
a
c
c
c
c
c
c
c
"}
(74,1,1) = {"
c
c
c
c
c
c
c
a
a
a
a
a
a
a
a
a
a
a
a
a
a
a
a
a
a
a
a
a
a
c
c
c
c
c
c
c
"}
(75,1,1) = {"
c
c
c
c
c
c
c
a
a
a
a
a
a
a
a
a
a
a
a
a
a
a
a
a
a
a
a
a
a
c
c
c
c
c
c
c
"}
(76,1,1) = {"
c
c
c
c
c
c
c
a
a
a
a
a
a
a
a
a
a
a
a
a
a
a
a
a
a
a
a
a
a
c
c
c
c
c
c
c
"}
(77,1,1) = {"
c
c
c
c
c
c
c
a
a
a
a
a
a
a
a
a
a
a
a
a
a
a
a
a
a
a
a
a
a
c
c
c
c
c
c
c
"}
(78,1,1) = {"
H
N
k
D
U
a
a
a
a
a
a
a
a
a
a
a
a
a
a
a
a
a
a
a
a
a
a
a
a
a
a
a
c
c
c
c
"}
(79,1,1) = {"
p
j
o
x
a
K
a
a
a
a
a
a
a
a
a
a
a
a
a
a
a
a
a
a
a
a
a
a
a
a
a
a
c
c
c
c
"}
(80,1,1) = {"
O
y
V
F
a
a
a
a
a
a
a
a
a
a
a
a
a
a
a
a
a
a
a
a
a
a
a
a
a
a
a
a
c
c
c
c
"}
(81,1,1) = {"
H
P
C
Y
a
a
a
a
a
a
a
a
a
a
a
a
a
a
a
a
a
a
a
a
a
a
a
a
a
a
a
a
c
c
c
c
"}
(82,1,1) = {"
X
c
c
c
c
c
c
a
a
a
a
a
a
a
a
a
a
a
a
a
a
a
a
a
a
a
a
a
a
c
c
c
c
c
c
c
"}
(83,1,1) = {"
m
c
c
c
c
c
c
a
a
a
a
a
a
a
a
a
a
a
a
a
a
a
a
a
a
a
a
a
a
c
c
c
c
c
c
c
"}
(84,1,1) = {"
X
X
c
c
c
c
c
a
a
a
a
a
a
a
a
a
a
a
a
a
a
a
a
a
a
a
a
a
a
c
c
c
c
c
c
c
"}
(85,1,1) = {"
I
X
n
c
c
c
c
a
a
a
a
a
a
a
a
a
a
a
a
a
a
a
a
a
a
a
a
a
a
c
c
c
c
c
c
c
"}
(86,1,1) = {"
S
W
n
c
c
c
c
a
a
a
a
a
a
a
a
a
a
a
a
a
a
a
a
a
a
a
a
a
a
c
c
c
c
c
c
c
"}
(87,1,1) = {"
E
T
n
c
c
c
c
a
a
a
a
a
a
a
a
a
a
a
a
a
a
a
a
a
a
a
a
a
a
c
c
c
c
c
c
c
"}
(88,1,1) = {"
G
Q
n
c
c
c
c
a
a
a
a
a
a
a
a
a
a
a
a
a
a
a
a
a
a
a
a
a
a
c
c
c
c
c
c
c
"}
(89,1,1) = {"
h
X
n
c
c
c
c
a
a
a
a
a
a
a
a
a
a
a
a
a
a
a
a
a
a
a
a
a
a
c
c
c
c
c
c
c
"}
(90,1,1) = {"
X
X
c
c
c
c
c
a
a
a
a
a
a
a
a
a
a
a
a
a
a
a
a
a
a
a
a
a
a
c
c
c
c
c
c
c
"}
(91,1,1) = {"
m
c
c
c
c
c
c
a
a
a
a
a
a
a
a
a
a
a
a
a
a
a
a
a
a
a
a
a
a
c
c
c
c
c
c
c
"}
(92,1,1) = {"
X
c
c
c
c
c
c
a
a
a
a
a
a
a
a
a
a
a
a
a
a
a
a
a
a
a
a
a
a
c
c
c
c
c
c
c
"}
(93,1,1) = {"
H
N
k
Y
a
a
a
a
a
a
a
a
a
a
a
a
a
a
a
a
a
a
a
a
a
a
a
a
a
a
a
a
c
c
c
c
"}
(94,1,1) = {"
z
Z
A
v
a
B
a
a
a
a
a
a
a
a
a
a
a
a
a
a
a
a
a
a
a
a
a
a
a
a
a
a
c
c
c
c
"}
(95,1,1) = {"
R
b
J
L
a
a
a
a
a
a
a
a
a
a
a
a
a
a
a
a
a
a
a
a
a
a
a
a
a
a
a
a
c
c
c
c
"}
(96,1,1) = {"
H
P
d
D
U
a
a
a
a
a
a
a
a
a
a
a
a
a
a
a
a
a
a
a
a
a
a
a
a
a
a
a
c
c
c
c
"}
(97,1,1) = {"
c
c
c
c
c
c
c
a
a
a
a
a
a
a
a
a
a
a
a
a
a
a
a
a
a
a
a
a
a
c
c
c
c
c
c
c
"}
(98,1,1) = {"
c
c
c
c
c
c
c
a
a
a
a
a
a
a
a
a
a
a
a
a
a
a
a
a
a
a
a
a
a
c
c
c
c
c
c
c
"}
(99,1,1) = {"
c
c
c
c
c
c
c
a
a
a
a
a
a
a
a
a
a
a
a
a
a
a
a
a
a
a
a
a
a
c
c
c
c
c
c
c
"}
(100,1,1) = {"
c
c
c
c
c
c
c
a
a
a
a
a
a
a
a
a
a
a
a
a
a
a
a
a
a
a
a
a
a
c
c
c
c
c
c
c
"}
(101,1,1) = {"
c
c
c
c
c
c
c
a
a
a
a
a
a
a
a
a
a
a
a
a
a
a
a
a
a
a
a
a
a
c
c
c
c
c
c
c
"}
(102,1,1) = {"
c
c
c
c
c
c
c
a
a
a
a
a
a
a
a
a
a
a
a
a
a
a
a
a
a
a
a
a
a
c
c
c
c
c
c
c
"}
(103,1,1) = {"
c
c
c
c
c
c
c
a
a
a
a
a
a
a
a
a
a
a
a
a
a
a
a
a
a
a
a
a
a
c
c
c
c
c
c
c
"}
(104,1,1) = {"
c
a
a
a
a
a
c
a
a
a
a
a
a
a
a
a
a
a
a
a
a
a
a
a
a
a
a
a
a
c
a
a
a
a
a
c
"}
(105,1,1) = {"
c
a
a
a
a
a
c
a
a
a
a
a
a
a
a
a
a
a
a
a
a
a
a
a
a
a
a
a
a
c
a
a
a
a
a
c
"}
(106,1,1) = {"
c
a
a
a
a
a
c
a
a
a
a
a
a
a
a
a
a
a
a
a
a
a
a
a
a
a
a
a
a
c
a
a
a
a
a
c
"}
(107,1,1) = {"
c
a
a
a
a
a
a
a
a
a
a
a
a
a
a
a
a
a
a
a
a
a
a
a
a
a
a
a
a
a
a
a
a
a
a
c
"}
(108,1,1) = {"
c
a
a
a
a
a
a
a
a
a
a
a
a
a
a
a
a
a
a
a
a
a
a
a
a
a
a
a
a
a
a
a
a
a
a
c
"}
(109,1,1) = {"
c
a
a
a
a
a
a
a
a
a
a
a
a
a
a
a
a
a
a
a
a
a
a
a
a
a
a
a
a
a
a
a
a
a
a
c
"}
(110,1,1) = {"
c
a
a
a
a
a
c
a
a
a
a
a
a
a
a
a
a
a
a
a
a
a
a
a
a
a
a
a
a
c
a
a
a
a
a
c
"}
(111,1,1) = {"
c
a
a
a
a
a
c
a
a
a
a
a
a
a
a
a
a
a
a
a
a
a
a
a
a
a
a
a
a
c
a
a
a
a
a
c
"}
(112,1,1) = {"
c
a
a
a
a
a
c
a
a
a
a
a
a
a
a
a
a
a
a
a
a
a
a
a
a
a
a
a
a
c
a
a
a
a
a
c
"}
(113,1,1) = {"
c
a
a
a
a
a
c
a
a
a
a
a
a
a
a
a
a
a
a
a
a
a
a
a
a
a
a
a
a
c
a
a
a
a
a
c
"}
(114,1,1) = {"
c
a
a
a
a
a
c
a
a
a
a
a
a
a
a
a
a
a
a
a
a
a
a
a
a
a
a
a
a
c
a
a
a
a
a
c
"}
(115,1,1) = {"
c
a
a
a
a
a
c
a
a
a
a
a
a
a
a
a
a
a
a
a
a
a
a
a
a
a
a
a
a
c
a
a
a
a
a
c
"}
(116,1,1) = {"
c
a
a
a
a
a
a
a
a
a
a
a
a
a
a
a
a
a
a
a
a
a
a
a
a
a
a
a
a
a
a
a
a
a
a
c
"}
(117,1,1) = {"
c
a
a
a
a
a
a
a
a
a
a
a
a
a
a
a
a
a
a
a
a
a
a
a
a
a
a
a
a
a
a
a
a
a
a
c
"}
(118,1,1) = {"
c
a
a
a
a
a
a
a
a
a
a
a
a
a
a
a
a
a
a
a
a
a
a
a
a
a
a
a
a
a
a
a
a
a
a
c
"}
(119,1,1) = {"
c
a
a
a
a
a
c
a
a
a
a
a
a
a
a
a
a
a
a
a
a
a
a
a
a
a
a
a
a
c
a
a
a
a
a
c
"}
(120,1,1) = {"
c
a
a
a
a
a
c
a
a
a
a
a
a
a
a
a
a
a
a
a
a
a
a
a
a
a
a
a
a
c
a
a
a
a
a
c
"}
(121,1,1) = {"
c
a
a
a
a
a
c
a
a
a
a
a
a
a
a
a
a
a
a
a
a
a
a
a
a
a
a
a
a
c
a
a
a
a
a
c
"}
(122,1,1) = {"
c
a
a
a
a
a
c
a
a
a
a
a
a
a
a
a
a
a
a
a
a
a
a
a
a
a
a
a
a
c
a
a
a
a
a
c
"}
(123,1,1) = {"
c
a
a
a
a
a
c
a
a
a
a
a
a
a
a
a
a
a
a
a
a
a
a
a
a
a
a
a
a
c
a
a
a
a
a
c
"}
(124,1,1) = {"
c
a
a
a
a
a
c
a
a
a
a
a
a
a
a
a
a
a
a
a
a
a
a
a
a
a
a
a
a
c
a
a
a
a
a
c
"}
(125,1,1) = {"
c
a
a
a
a
a
a
a
a
a
a
a
a
a
a
a
a
a
a
a
a
a
a
a
a
a
a
a
a
a
a
a
a
a
a
c
"}
(126,1,1) = {"
c
a
a
a
a
a
a
a
a
a
a
a
a
a
a
a
a
a
a
a
a
a
a
a
a
a
a
a
a
a
a
a
a
a
a
c
"}
(127,1,1) = {"
c
a
a
a
a
a
a
a
a
a
a
a
a
a
a
a
a
a
a
a
a
a
a
a
a
a
a
a
a
a
a
a
a
a
a
c
"}
(128,1,1) = {"
c
a
a
a
a
a
c
a
a
a
a
a
a
a
a
a
a
a
a
a
a
a
a
a
a
a
a
a
a
c
a
a
a
a
a
c
"}
(129,1,1) = {"
c
a
a
a
a
a
c
a
a
a
a
a
a
a
a
a
a
a
a
a
a
a
a
a
a
a
a
a
a
c
a
a
a
a
a
c
"}
(130,1,1) = {"
c
a
a
a
a
a
c
a
a
a
a
a
a
a
a
a
a
a
a
a
a
a
a
a
a
a
a
a
a
c
a
a
a
a
a
c
"}
(131,1,1) = {"
c
c
c
c
c
c
c
c
a
a
a
a
a
a
a
a
a
a
a
a
a
a
a
a
a
a
a
a
c
c
c
c
c
c
c
c
"}
(132,1,1) = {"
c
c
c
c
c
c
c
c
a
a
a
a
a
a
a
a
a
a
a
a
a
a
a
a
a
a
a
a
c
c
c
c
c
c
c
c
"}
(133,1,1) = {"
c
c
c
c
c
c
c
c
a
a
a
a
a
a
a
a
a
a
a
a
a
a
a
a
a
a
a
a
c
c
c
c
c
c
c
c
"}
(134,1,1) = {"
c
c
c
c
c
c
c
c
a
a
a
a
a
a
a
a
a
a
a
a
a
a
a
a
a
a
a
a
c
c
c
c
c
c
c
c
"}
(135,1,1) = {"
c
c
c
c
c
c
c
c
a
a
a
a
a
a
a
a
a
a
a
a
a
a
a
a
a
a
a
a
c
c
c
c
c
c
c
c
"}
(136,1,1) = {"
c
c
c
c
c
c
c
c
a
a
a
a
a
a
a
a
a
a
a
a
a
a
a
a
a
a
a
a
c
c
c
c
c
c
c
c
"}
